#north
0 *x** -> E 3
0 xE** -> N 0
0 NEx* -> W 2
0 NEWx -> S 1

#south
1 **x* -> W 2
1 **Wx -> S 1
1 *xWS -> E 3
1 xEWS -> N 0

#west
2 x*** -> N 0
2 N*x* -> W 2
2 N*Wx -> S 1
2 NxWS -> E 3

#east
3 ***x -> S 1
3 *x*S -> E 3
3 xE*S -> N 0
3 NExS -> W 2